NO            maps/north_texture.xpm             
SO  maps/djesse.xpm  
WE maps/west_texture.xpm
EA     maps/east_texture.xpm    

S      maps/ddnet.xpm

C 127     ,   8,58             
R 1920        1080
F       255,87,  51

   111  1111111111111111111111111111
111     100000000011000000200001
111     1011000001110000002000011
        1001000000000000000000001
111111111011000001110000000000011
100000000011000001110111111111111
11110111111111011100000010201
11110111111111011101010011011
110000001101010111000000100011
10002000000000000110000001N001
100000000000000011010100000001
1100000111010101111101111000011
11110111 1110101 1011110100011
11111111 1111111 111111111111
111111111111111111111111111111111111111111111111111
1           0                                     11
1                   2                              1
1                    2                             1
1                   2                             11
1                                                 1
1                                                 1
1                                                 1
1       2                 2                       1
1      2                  2                      11
1                       2                         11
1                           2                      1
1     2                                           11
1                       2                         1
1                                                 11
1                                                 11
1                         22                       1
1111111111111111111111111111111111111111111111111111
000000000
1111111
00000000
1







